"DEPARTAMENTO","PROVINCIA","MUNICIPIO","INSCRITOS RE-ELECCIÓN","INSCRITOS ELECCIÓN NACIONAL","DIFERENCIA INSCRITOS","DIFERENCIA INSCRITOS %","EMITIDOS RE-ELECCIÓN","EMITIDOS ELECCIÓN NACIONAL","DIFERENCIA EMITIDOS","DIFERENCIA EMITIDOS %","VÁLIDOS RE-ELECCIÓN","VÁLIDOS ELECCIÓN NACIONAL","DIFERENCIA VÁLIDOS","DIFERENCIA VÁLIDOS %","EVO RE-ELECCIÓN","EVO ELECCIÓN NACIONAL","DIFERENCIA EVO","EVO ELECCIÓN NACIONAL %","DIFERENCIA EVO % EN VOTOS","EVO RE-ELECCIÓN %","DIFERENCIA EVO % EN PORCENTAJES","PERDIDA"
"BENI","CERCADO","SAN JAVIER",1692,1556,136,8.04,1354,1286,68,5.02,1287,1182,105,8.16,656,637,19,53.89,2.9,50.97,-2.92,FALSE
"BENI","CERCADO","TRINIDAD",73647,71660,1987,2.7,61342,61515,-173,-0.28,59370,58633,737,1.24,20439,21170,-731,36.11,-3.58,34.43,-1.68,TRUE
"BENI","GENERAL JOSÉ BALLIVIÁN","REYES",5299,5074,225,4.25,4048,4200,-152,-3.75,3866,3955,-89,-2.3,1710,1725,-15,43.62,-0.88,44.23,0.609999999999999,TRUE
"BENI","GENERAL JOSÉ BALLIVIÁN","RURRENABAQUE",10019,9583,436,4.35,7889,7949,-60,-0.76,7496,7468,28,0.37,3418,3887,-469,52.05,-13.72,45.6,-6.45,TRUE
"BENI","GENERAL JOSÉ BALLIVIÁN","SAN BORJA",20188,18559,1629,8.07,16169,15558,611,3.78,15564,14526,1038,6.67,8375,8422,-47,57.98,-0.56,53.81,-4.16999999999999,TRUE
"BENI","GENERAL JOSÉ BALLIVIÁN","SANTA ROSA",4988,4414,574,11.51,3884,3717,167,4.3,3744,3518,226,6.04,1290,1605,-315,45.62,-24.42,34.46,-11.16,TRUE
"BENI","ITÉNEZ","BAURES",2911,2638,273,9.38,2203,2283,-80,-3.63,2158,2211,-53,-2.46,1113,1151,-38,52.06,-3.41,51.58,-0.480000000000004,TRUE
"BENI","ITÉNEZ","HUACARAJE",2068,1820,248,11.99,1623,1544,79,4.87,1578,1504,74,4.69,666,617,49,41.02,7.36,42.21,1.19,FALSE
"BENI","ITÉNEZ","MAGDALENA",5793,5472,321,5.54,4747,4757,-10,-0.21,4614,4554,60,1.3,2130,1873,257,41.13,12.07,46.16,5.02999999999999,FALSE
"BENI","MAMORÉ","PUERTO SILES",435,396,39,8.97,327,303,24,7.34,317,290,27,8.52,172,127,45,43.79,26.16,54.26,10.47,FALSE
"BENI","MAMORÉ","SAN JOAQUÍN",3053,2888,165,5.4,2216,2262,-46,-2.08,2092,2173,-81,-3.87,980,1023,-43,47.08,-4.39,46.85,-0.229999999999997,TRUE
"BENI","MAMORÉ","SAN RAMÓN",2392,2165,227,9.49,1915,1818,97,5.07,1874,1636,238,12.7,867,767,100,46.88,11.53,46.26,-0.620000000000005,FALSE
"BENI","MARBÁN","LORETO",1730,1687,43,2.49,1274,1284,-10,-0.78,1236,1190,46,3.72,670,624,46,52.44,6.87,54.21,1.77,FALSE
"BENI","MARBÁN","SAN ANDRÉS",5178,4820,358,6.91,4083,3915,168,4.11,3945,3602,343,8.69,2195,2162,33,60.02,1.5,55.64,-4.38,FALSE
"BENI","MOXOS","SAN IGNACIO",10197,9761,436,4.28,8123,8307,-184,-2.27,7779,7737,42,0.54,4801,5184,-383,67,-7.98,61.72,-5.28,TRUE
"BENI","VACA DIEZ","GUAYARAMERÍN",24080,23352,728,3.02,18569,19222,-653,-3.52,18079,18241,-162,-0.9,6215,6731,-516,36.9,-8.3,34.38,-2.52,TRUE
"BENI","VACA DIEZ","RIBERALTA",48940,48551,389,0.79,37510,41336,-3826,-10.2,36119,39178,-3059,-8.47,11453,13388,-1935,34.17,-16.9,31.71,-2.46,TRUE
"BENI","YACUMA","EXALTACIÓN",1068,1085,-17,-1.59,834,896,-62,-7.43,824,869,-45,-5.46,528,516,12,59.38,2.27,64.08,4.7,FALSE
"BENI","YACUMA","SANTA ANA DE YACUMA",8569,8117,452,5.27,6560,6457,103,1.57,6366,6093,273,4.29,2363,2475,-112,40.62,-4.74,37.12,-3.5,TRUE
"CHUQUISACA","AZURDUY","AZURDUY",4443,4318,125,2.81,3540,3615,-75,-2.12,3309,2989,320,9.67,2499,2472,27,82.7,1.08,75.52,-7.18000000000001,FALSE
"CHUQUISACA","AZURDUY","TARVITA",5480,5408,72,1.31,4487,4757,-270,-6.02,4211,4144,67,1.59,3011,3776,-765,91.12,-25.41,71.5,-19.62,TRUE
"CHUQUISACA","BELISARIO BOETO","VILLA SERRANO",5742,5675,67,1.17,4682,4881,-199,-4.25,4363,4306,57,1.31,3118,3629,-511,84.28,-16.39,71.46,-12.82,TRUE
"CHUQUISACA","HERNANDO SILES","MONTEAGUDO",13882,13242,640,4.61,11625,11653,-28,-0.24,10941,10648,293,2.68,5850,7703,-1853,72.34,-31.68,53.47,-18.87,TRUE
"CHUQUISACA","HERNANDO SILES","SAN PABLO DE HUACARETA",4156,3918,238,5.73,3273,3250,23,0.7,3103,2907,196,6.32,1530,1847,-317,63.54,-20.72,49.31,-14.23,TRUE
"CHUQUISACA","LUIS CALVO","HUACAYA",1162,1086,76,6.54,936,918,18,1.92,908,844,64,7.05,651,717,-66,84.95,-10.14,71.7,-13.25,TRUE
"CHUQUISACA","LUIS CALVO","MACHARETÍ",3547,3335,212,5.98,2846,2797,49,1.72,2646,2600,46,1.74,1488,1810,-322,69.62,-21.64,56.24,-13.38,TRUE
"CHUQUISACA","LUIS CALVO","MUYUPAMPA (VILLA VACA GUZMÁN)",4935,4682,253,5.13,4083,4061,22,0.54,3851,3652,199,5.17,2015,2737,-722,74.95,-35.83,52.32,-22.63,TRUE
"CHUQUISACA","NOR CINTI","CAMARGO",7772,7516,256,3.29,6275,6534,-259,-4.13,5948,6152,-204,-3.43,3281,4493,-1212,73.03,-36.94,55.16,-17.87,TRUE
"CHUQUISACA","NOR CINTI","INCAHUASI",3873,3720,153,3.95,3073,3103,-30,-0.98,2894,2752,142,4.91,2266,2167,99,78.74,4.37,78.3,-0.439999999999998,FALSE
"CHUQUISACA","NOR CINTI","SAN LUCAS",13113,13126,-13,-0.1,10125,10966,-841,-8.31,9516,10107,-591,-6.21,7967,9287,-1320,91.89,-16.57,83.72,-8.17,TRUE
"CHUQUISACA","NOR CINTI","VILLA CHARCAS",5683,5562,121,2.13,4560,4674,-114,-2.5,4229,4142,87,2.06,3316,3572,-256,86.24,-7.72,78.41,-7.83,TRUE
"CHUQUISACA","OROPEZA","POROMA",6256,5797,459,7.34,4927,4757,170,3.45,4572,4188,384,8.4,3514,3854,-340,92.02,-9.68,76.86,-15.16,TRUE
"CHUQUISACA","OROPEZA","SUCRE",199060,189927,9133,4.59,173966,169927,4039,2.32,165757,158899,6858,4.14,48686,80099,-31413,50.41,-64.52,29.37,-21.04,TRUE
"CHUQUISACA","OROPEZA","YOTALA",4737,4518,219,4.62,4039,3968,71,1.76,3821,3670,151,3.95,2479,3032,-553,82.62,-22.31,64.88,-17.74,TRUE
"CHUQUISACA","SUD CINTI","CAMATAQUI (VILLA ABECIA)",1568,1520,48,3.06,1268,1320,-52,-4.1,1155,1201,-46,-3.98,787,956,-169,79.6,-21.47,68.14,-11.46,TRUE
"CHUQUISACA","SUD CINTI","CULPINA",7546,7088,458,6.07,5822,6031,-209,-3.59,5303,5494,-191,-3.6,3435,4424,-989,80.52,-28.79,64.77,-15.75,TRUE
"CHUQUISACA","SUD CINTI","LAS CARRERAS",1563,1514,49,3.13,1301,1311,-10,-0.77,1223,1228,-5,-0.41,905,1048,-143,85.34,-15.8,74,-11.34,TRUE
"CHUQUISACA","TOMINA","EL VILLAR",1967,1907,60,3.05,1624,1691,-67,-4.13,1515,1476,39,2.57,1164,1321,-157,89.5,-13.49,76.83,-12.67,TRUE
"CHUQUISACA","TOMINA","PADILLA",5480,5238,242,4.42,4565,4621,-56,-1.23,4300,4147,153,3.56,2889,3447,-558,83.12,-19.31,67.19,-15.93,TRUE
"CHUQUISACA","TOMINA","SOPACHUY",3136,3004,132,4.21,2679,2636,43,1.61,2544,2283,261,10.26,2062,2031,31,88.96,1.5,81.05,-7.91,FALSE
"CHUQUISACA","TOMINA","TOMINA",3777,3653,124,3.28,3191,3184,7,0.22,2980,2857,123,4.13,2352,2650,-298,92.75,-12.67,78.93,-13.82,TRUE
"CHUQUISACA","TOMINA","VILLA ALCALÁ",1564,1518,46,2.94,1189,1371,-182,-15.31,1113,1209,-96,-8.63,783,1013,-230,83.79,-29.37,70.35,-13.44,TRUE
"CHUQUISACA","YAMPARAEZ","TARABUCO",8324,8384,-60,-0.72,6730,7037,-307,-4.56,6219,6080,139,2.24,4555,5412,-857,89.01,-18.81,73.24,-15.77,TRUE
"CHUQUISACA","YAMPARAEZ","YAMPARÁEZ",4190,4157,33,0.79,3502,3631,-129,-3.68,3252,3257,-5,-0.15,2488,2980,-492,91.5,-19.77,76.51,-14.99,TRUE
"CHUQUISACA","ZUDAÑEZ","ICLA",3489,3452,37,1.06,2753,3065,-312,-11.33,2646,2818,-172,-6.5,2191,2676,-485,94.96,-22.14,82.8,-12.16,TRUE
"CHUQUISACA","ZUDAÑEZ","MOJOCOYA",3339,3261,78,2.34,2752,2802,-50,-1.82,2620,2552,68,2.6,1813,2261,-448,88.6,-24.71,69.2,-19.4,TRUE
"CHUQUISACA","ZUDAÑEZ","PRESTO",3369,3239,130,3.86,2606,2766,-160,-6.14,2370,2368,2,0.08,1646,2069,-423,87.37,-25.7,69.45,-17.92,TRUE
"CHUQUISACA","ZUDAÑEZ","VILLA ZUDAÑEZ",3462,3364,98,2.83,2909,2891,18,0.62,2731,2592,139,5.09,2163,2302,-139,88.81,-6.43,79.2,-9.61,TRUE
"COCHABAMBA","ARANI","ARANI",6804,6705,99,1.46,5884,5992,-108,-1.84,5504,5411,93,1.69,3386,4385,-999,81.04,-29.5,61.52,-19.52,TRUE
"COCHABAMBA","ARANI","VACAS",4771,4818,-47,-0.99,4243,4377,-134,-3.16,3928,3951,-23,-0.59,3419,3784,-365,95.77,-10.68,87.04,-8.72999999999999,TRUE
"COCHABAMBA","ARQUE","ARQUE",4199,4196,3,0.07,3564,3690,-126,-3.54,3316,3279,37,1.12,3045,3164,-119,96.49,-3.91,91.83,-4.66,TRUE
"COCHABAMBA","ARQUE","TACOPAYA",4386,4384,2,0.05,3858,3992,-134,-3.47,3606,3652,-46,-1.28,3230,3513,-283,96.19,-8.76,89.57,-6.62,TRUE
"COCHABAMBA","AYOPAYA","COCAPATA",7094,6337,757,10.67,6046,5439,607,10.04,5632,4965,667,11.84,4460,4708,-248,94.82,-5.56,79.19,-15.63,TRUE
"COCHABAMBA","AYOPAYA","INDEPENDENCIA",10635,9610,1025,9.64,9098,8464,634,6.97,8350,7391,959,11.49,6833,6793,40,91.91,0.59,81.83,-10.08,FALSE
"COCHABAMBA","AYOPAYA","MOROCHATA",6474,6053,421,6.5,5701,5477,224,3.93,5182,4842,340,6.56,4373,4687,-314,96.8,-7.18,84.39,-12.41,TRUE
"COCHABAMBA","BOLIVAR","BOLIVAR",3720,3571,149,4.01,3262,3213,49,1.5,3048,2925,123,4.04,2380,2745,-365,93.85,-15.34,78.08,-15.77,TRUE
"COCHABAMBA","CAMPERO","AIQUILE",13080,12744,336,2.57,10988,11280,-292,-2.66,10311,10219,92,0.89,6884,8350,-1466,81.71,-21.3,66.76,-14.95,TRUE
"COCHABAMBA","CAMPERO","OMEREQUE",2901,2678,223,7.69,2463,2308,155,6.29,2340,2123,217,9.27,1691,1844,-153,86.86,-9.05,72.26,-14.6,TRUE
"COCHABAMBA","CAMPERO","PASORAPA",1631,1484,147,9.01,1335,1253,82,6.14,1280,1155,125,9.77,774,845,-71,73.16,-9.17,60.47,-12.69,TRUE
"COCHABAMBA","CAPINOTA","CAPINOTA",11872,11355,517,4.35,10425,10373,52,0.5,9775,9458,317,3.24,6336,7987,-1651,84.45,-26.06,64.82,-19.63,TRUE
"COCHABAMBA","CAPINOTA","SANTIVAÑEZ",4353,4166,187,4.3,3766,3755,11,0.29,3607,3472,135,3.74,2845,3126,-281,90.03,-9.88,78.87,-11.16,TRUE
"COCHABAMBA","CAPINOTA","SICAYA",1536,1454,82,5.34,1352,1331,21,1.55,1238,1181,57,4.6,1088,1116,-28,94.5,-2.57,87.88,-6.62,TRUE
"COCHABAMBA","CARRASCO","CHIMORÉ",13181,12944,237,1.8,11171,11473,-302,-2.7,10683,10930,-247,-2.31,8523,9888,-1365,90.47,-16.02,79.78,-10.69,TRUE
"COCHABAMBA","CARRASCO","ENTRE RÍOS",20175,19202,973,4.82,17951,17462,489,2.72,17306,16425,881,5.09,14947,15628,-681,95.15,-4.56,86.37,-8.78,TRUE
"COCHABAMBA","CARRASCO","POCONA",5896,5330,566,9.6,5266,4854,412,7.82,4954,4350,604,12.19,4204,4106,98,94.39,2.33,84.86,-9.53,FALSE
"COCHABAMBA","CARRASCO","POJO",5200,4984,216,4.15,4644,4525,119,2.56,4448,4319,129,2.9,4061,4066,-5,94.14,-0.12,91.3,-2.84,TRUE
"COCHABAMBA","CARRASCO","PUERTO VILLARROEL",29410,28065,1345,4.57,25916,25781,135,0.52,25014,24327,687,2.75,21735,22740,-1005,93.48,-4.62,86.89,-6.59,TRUE
"COCHABAMBA","CARRASCO","TOTORA",7406,7362,44,0.59,6637,6610,27,0.41,6355,6115,240,3.78,5440,5706,-266,93.31,-4.89,85.6,-7.71000000000001,TRUE
"COCHABAMBA","CERCADO","COCHABAMBA",472919,454997,17922,3.79,414434,408963,5471,1.32,400604,390113,10491,2.62,167911,199038,-31127,51.02,-18.54,41.91,-9.11000000000001,TRUE
"COCHABAMBA","CHAPARE","COLOMI",11758,11350,408,3.47,10390,10252,138,1.33,9628,9316,312,3.24,6901,8388,-1487,90.04,-21.55,71.68,-18.36,TRUE
"COCHABAMBA","CHAPARE","SACABA",119886,111799,8087,6.75,105703,101781,3922,3.71,101197,95620,5577,5.51,47135,61124,-13989,63.92,-29.68,46.58,-17.34,TRUE
"COCHABAMBA","CHAPARE","VILLA TUNARI",40010,39010,1000,2.5,35614,35791,-177,-0.5,34367,34089,278,0.81,30020,32553,-2533,95.49,-8.44,87.35,-8.14,TRUE
"COCHABAMBA","ESTEBAN ARCE","ANZALDO",3424,3486,-62,-1.81,2875,2971,-96,-3.34,2631,2449,182,6.92,1946,2149,-203,87.75,-10.43,73.96,-13.79,TRUE
"COCHABAMBA","ESTEBAN ARCE","ARBIETO",7812,6465,1347,17.24,6729,5603,1126,16.73,6350,5083,1267,19.95,4841,4403,438,86.62,9.05,76.24,-10.38,FALSE
"COCHABAMBA","ESTEBAN ARCE","SACABAMBA",2218,2057,161,7.26,1919,1840,79,4.12,1778,1693,85,4.78,1400,1581,-181,93.38,-12.93,78.74,-14.64,TRUE
"COCHABAMBA","ESTEBAN ARCE","TARATA",6518,6232,286,4.39,5296,5424,-128,-2.42,5036,5052,-16,-0.32,3666,4185,-519,82.84,-14.16,72.8,-10.04,TRUE
"COCHABAMBA","GERMAN JORDAN","CLIZA",13797,13178,619,4.49,11649,11523,126,1.08,11141,10750,391,3.51,7113,8693,-1580,80.87,-22.21,63.85,-17.02,TRUE
"COCHABAMBA","GERMAN JORDAN","TOCO",3181,3186,-5,-0.16,2627,2714,-87,-3.31,2494,2491,3,0.12,1989,2275,-286,91.33,-14.38,79.75,-11.58,TRUE
"COCHABAMBA","GERMAN JORDAN","TOLATA",4574,4535,39,0.85,3611,3842,-231,-6.4,3393,3541,-148,-4.36,2093,2899,-806,81.87,-38.51,61.69,-20.18,TRUE
"COCHABAMBA","MIZQUE","ALALAY",1306,1215,91,6.97,1108,1053,55,4.96,1056,981,75,7.1,909,942,-33,96.02,-3.63,86.08,-9.94,TRUE
"COCHABAMBA","MIZQUE","MIZQUE",13596,12928,668,4.91,11940,11551,389,3.26,11204,10356,848,7.57,8831,9384,-553,90.61,-6.26,78.82,-11.79,TRUE
"COCHABAMBA","MIZQUE","VILA VILA",1651,1621,30,1.82,1421,1383,38,2.67,1352,1272,80,5.92,1248,1225,23,96.31,1.84,92.31,-4,FALSE
"COCHABAMBA","PUNATA","CUCHUMUELA (VILLA GUALBERTO VILLARROEL)",934,862,72,7.71,834,790,44,5.28,790,730,60,7.59,539,627,-88,85.89,-16.33,68.23,-17.66,TRUE
"COCHABAMBA","PUNATA","PUNATA",22244,21441,803,3.61,18828,18624,204,1.08,17608,17120,488,2.77,9556,13173,-3617,76.95,-37.85,54.27,-22.68,TRUE
"COCHABAMBA","PUNATA","SAN BENITO",9073,8823,250,2.76,7965,7896,69,0.87,7562,7328,234,3.09,5236,6389,-1153,87.19,-22.02,69.24,-17.95,TRUE
"COCHABAMBA","PUNATA","TACACHI",559,615,-56,-10.02,471,521,-50,-10.62,441,472,-31,-7.03,263,354,-91,75,-34.6,59.64,-15.36,TRUE
"COCHABAMBA","PUNATA","VILLA RIVERO",5429,5484,-55,-1.01,4456,4696,-240,-5.39,4206,4322,-116,-2.76,3067,3888,-821,89.96,-26.77,72.92,-17.04,TRUE
"COCHABAMBA","QUILLACOLLO","COLCAPIRHUA",35516,34245,1271,3.58,31512,31209,303,0.96,30343,29645,698,2.3,13187,16499,-3312,55.66,-25.12,43.46,-12.2,TRUE
"COCHABAMBA","QUILLACOLLO","QUILLACOLLO",103782,98985,4797,4.62,91607,89149,2458,2.68,87669,84070,3599,4.11,43269,53785,-10516,63.98,-24.3,49.35,-14.63,TRUE
"COCHABAMBA","QUILLACOLLO","SIPE SIPE",28796,26774,2022,7.02,25377,24524,853,3.36,23918,22435,1483,6.2,16139,18675,-2536,83.24,-15.71,67.48,-15.76,TRUE
"COCHABAMBA","QUILLACOLLO","TIQUIPAYA",36490,34330,2160,5.92,32339,31073,1266,3.91,31021,29515,1506,4.85,15301,18153,-2852,61.5,-18.64,49.32,-12.18,TRUE
"COCHABAMBA","QUILLACOLLO","VINTO",34407,32447,1960,5.7,30410,29727,683,2.25,28720,27635,1085,3.78,16311,20149,-3838,72.91,-23.53,56.79,-16.12,TRUE
"COCHABAMBA","TAPACARI","TAPACARÍ",11342,10933,409,3.61,10048,9807,241,2.4,9410,8931,479,5.09,8645,8591,54,96.19,0.62,91.87,-4.31999999999999,FALSE
"COCHABAMBA","TIRAQUE","SHINAHOTA",13178,12605,573,4.35,11441,11436,5,0.04,10935,10879,56,0.51,8620,10132,-1512,93.13,-17.54,78.83,-14.3,TRUE
"COCHABAMBA","TIRAQUE","TIRAQUE",11472,11306,166,1.45,10210,10098,112,1.1,9429,9254,175,1.86,7720,8690,-970,93.91,-12.56,81.88,-12.03,TRUE
"LA PAZ","ABEL ITURRALDE","IXIAMAS",4109,3979,130,3.16,3100,3348,-248,-8,2979,3131,-152,-5.1,1565,1861,-296,59.44,-18.91,52.53,-6.91,TRUE
"LA PAZ","ABEL ITURRALDE","SAN BUENAVENTURA",4422,4120,302,6.83,3613,3593,20,0.55,3453,3346,107,3.1,1947,2220,-273,66.35,-14.02,56.39,-9.95999999999999,TRUE
"LA PAZ","AROMA","AYO AYO",3876,3670,206,5.31,3533,3396,137,3.88,3353,3190,163,4.86,2371,2948,-577,92.41,-24.34,70.71,-21.7,TRUE
"LA PAZ","AROMA","CALAMARCA",7453,7224,229,3.07,6843,6704,139,2.03,6427,6300,127,1.98,4421,5811,-1390,92.24,-31.44,68.79,-23.45,TRUE
"LA PAZ","AROMA","COLLANA",2013,1741,272,13.51,1840,1629,211,11.47,1752,1554,198,11.3,1127,1319,-192,84.88,-17.04,64.33,-20.55,TRUE
"LA PAZ","AROMA","COLQUENCHA",3983,3884,99,2.49,3696,3598,98,2.65,3493,3445,48,1.37,2420,2949,-529,85.6,-21.86,69.28,-16.32,TRUE
"LA PAZ","AROMA","PATACAMAYA",12779,12199,580,4.54,11297,11040,257,2.27,10804,10480,324,3,7611,9220,-1609,87.98,-21.14,70.45,-17.53,TRUE
"LA PAZ","AROMA","SICA SICA",11087,10830,257,2.32,10123,9974,149,1.47,9665,9353,312,3.23,7044,8428,-1384,90.11,-19.65,72.88,-17.23,TRUE
"LA PAZ","AROMA","UMALA",4021,3894,127,3.16,3581,3520,61,1.7,3388,3288,100,2.95,2474,2942,-468,89.48,-18.92,73.02,-16.46,TRUE
"LA PAZ","BAUTISTA SAAVEDRA","CHARAZANI",4350,4200,150,3.45,3783,3777,6,0.16,3478,3386,92,2.65,2858,3135,-277,92.59,-9.69,82.17,-10.42,TRUE
"LA PAZ","BAUTISTA SAAVEDRA","CURVA",845,820,25,2.96,716,719,-3,-0.42,656,658,-2,-0.3,534,616,-82,93.62,-15.36,81.4,-12.22,TRUE
"LA PAZ","CAMACHO","ESCOMA",3554,3536,18,0.51,3174,3242,-68,-2.14,2924,2921,3,0.1,2148,2645,-497,90.55,-23.14,73.46,-17.09,TRUE
"LA PAZ","CAMACHO","HUMANATA",2349,2382,-33,-1.4,2058,2109,-51,-2.48,1805,1889,-84,-4.65,1325,1755,-430,92.91,-32.45,73.41,-19.5,TRUE
"LA PAZ","CAMACHO","MOCOMOCO",6224,6222,2,0.03,5396,5553,-157,-2.91,4916,5017,-101,-2.05,3863,4610,-747,91.89,-19.34,78.58,-13.31,TRUE
"LA PAZ","CAMACHO","PUERTO ACOSTA",5384,5404,-20,-0.37,4843,4906,-63,-1.3,4520,4467,53,1.17,3063,3777,-714,84.55,-23.31,67.77,-16.78,TRUE
"LA PAZ","CAMACHO","PUERTO CARABUCO",6276,6335,-59,-0.94,5394,5559,-165,-3.06,4960,5025,-65,-1.31,3729,4469,-740,88.94,-19.84,75.18,-13.76,TRUE
"LA PAZ","CARANAVI","ALTO BENI",5048,4803,245,4.85,4376,4270,106,2.42,4154,4006,148,3.56,3283,3547,-264,88.54,-8.04,79.03,-9.51000000000001,TRUE
"LA PAZ","CARANAVI","CARANAVI",26863,26613,250,0.93,22500,23501,-1001,-4.45,21532,22151,-619,-2.87,15133,18317,-3184,82.69,-21.04,70.28,-12.41,TRUE
"LA PAZ","FRANZ TAMAYO","APOLO",7601,7379,222,2.92,6044,6018,26,0.43,5559,5117,442,7.95,2704,2940,-236,57.46,-8.73,48.64,-8.82,TRUE
"LA PAZ","FRANZ TAMAYO","PELECHUCO",3022,2804,218,7.21,2628,2562,66,2.51,2439,2298,141,5.78,1413,1881,-468,81.85,-33.12,57.93,-23.92,TRUE
"LA PAZ","GENERAL JOSÉ MANUEL PANDO","CATACORA",504,491,13,2.58,434,450,-16,-3.69,421,437,-16,-3.8,343,397,-54,90.85,-15.74,81.47,-9.38,TRUE
"LA PAZ","GENERAL JOSÉ MANUEL PANDO","SANTIAGO DE MACHACA",1933,1906,27,1.4,1618,1723,-105,-6.49,1558,1639,-81,-5.2,1288,1502,-214,91.64,-16.61,82.67,-8.97,TRUE
"LA PAZ","GUALBERTO VILLARROEL","CHACARILLA",831,743,88,10.59,745,665,80,10.74,715,633,82,11.47,583,601,-18,94.94,-3.09,81.54,-13.4,TRUE
"LA PAZ","GUALBERTO VILLARROEL","PAPEL PAMPA",3213,3177,36,1.12,2935,2902,33,1.12,2823,2739,84,2.98,2189,2436,-247,88.94,-11.28,77.54,-11.4,TRUE
"LA PAZ","GUALBERTO VILLARROEL","SAN PEDRO DE CURAHUARA",3464,3160,304,8.78,3228,2938,290,8.98,3129,2851,278,8.88,2735,2728,7,95.69,0.26,87.41,-8.28,FALSE
"LA PAZ","INGAVI","DESAGUADERO",3843,3772,71,1.85,3430,3445,-15,-0.44,3272,3112,160,4.89,1381,1935,-554,62.18,-40.12,42.21,-19.97,TRUE
"LA PAZ","INGAVI","GUAQUI",3989,4091,-102,-2.56,3422,3620,-198,-5.79,3183,3336,-153,-4.81,2295,2911,-616,87.26,-26.84,72.1,-15.16,TRUE
"LA PAZ","INGAVI","JESÚS DE MACHACA",5557,5540,17,0.31,5136,5138,-2,-0.04,4883,4724,159,3.26,3792,4375,-583,92.61,-15.37,77.66,-14.95,TRUE
"LA PAZ","INGAVI","SAN ANDRÉS DE MACHACA",2196,2197,-1,-0.05,1898,1997,-99,-5.22,1815,1841,-26,-1.43,1462,1738,-276,94.41,-18.88,80.55,-13.86,TRUE
"LA PAZ","INGAVI","TARACO",2579,2512,67,2.6,2351,2333,18,0.77,2196,2140,56,2.55,1753,2002,-249,93.55,-14.2,79.83,-13.72,TRUE
"LA PAZ","INGAVI","TIAHUANACU",5810,5601,209,3.6,5352,5200,152,2.84,5005,4673,332,6.63,3668,4215,-547,90.2,-14.91,73.29,-16.91,TRUE
"LA PAZ","INGAVI","VIACHA",44997,41897,3100,6.89,40694,38770,1924,4.73,38592,36698,1894,4.91,25209,29834,-4625,81.3,-18.35,65.32,-15.98,TRUE
"LA PAZ","INQUISIVI","CAJUATA",5346,5097,249,4.66,4691,4654,37,0.79,4406,4341,65,1.48,3609,4123,-514,94.98,-14.24,81.91,-13.07,TRUE
"LA PAZ","INQUISIVI","COLQUIRI",8989,8400,589,6.55,8038,7803,235,2.92,7400,7131,269,3.64,4819,6137,-1318,86.06,-27.35,65.12,-20.94,TRUE
"LA PAZ","INQUISIVI","ICHOCA",1897,1846,51,2.69,1665,1633,32,1.92,1567,1532,35,2.23,1262,1456,-194,95.04,-15.37,80.54,-14.5,TRUE
"LA PAZ","INQUISIVI","INQUISIVI",6367,5938,429,6.74,5281,5257,24,0.45,4881,4857,24,0.49,3964,4551,-587,93.7,-14.81,81.21,-12.49,TRUE
"LA PAZ","INQUISIVI","LICOMA PAMPA (VILLA LIBERTAD LICOMA)",1174,1128,46,3.92,996,1004,-8,-0.8,929,916,13,1.4,779,825,-46,90.07,-5.91,83.85,-6.22,TRUE
"LA PAZ","INQUISIVI","QUIME",3979,3822,157,3.95,3497,3423,74,2.12,3210,3157,53,1.65,2016,2580,-564,81.72,-27.98,62.8,-18.92,TRUE
"LA PAZ","LARECAJA","COMBAYA",1096,1094,2,0.18,982,992,-10,-1.02,866,908,-42,-4.85,685,843,-158,92.84,-23.07,79.1,-13.74,TRUE
"LA PAZ","LARECAJA","GUANAY",7186,6938,248,3.45,6000,6050,-50,-0.83,5770,5594,176,3.05,3385,3982,-597,71.18,-17.64,58.67,-12.51,TRUE
"LA PAZ","LARECAJA","MAPIRI",5886,5860,26,0.44,4652,5123,-471,-10.12,4431,4701,-270,-6.09,2746,3611,-865,76.81,-31.5,61.97,-14.84,TRUE
"LA PAZ","LARECAJA","QUIABAYA",1207,1145,62,5.14,1025,996,29,2.83,927,850,77,8.31,636,765,-129,90,-20.28,68.61,-21.39,TRUE
"LA PAZ","LARECAJA","SORATA",9778,9282,496,5.07,8673,8449,224,2.58,8005,7686,319,3.99,5324,6537,-1213,85.05,-22.78,66.51,-18.54,TRUE
"LA PAZ","LARECAJA","TACACOMA",3051,3082,-31,-1.02,2586,2738,-152,-5.88,2432,2484,-52,-2.14,1418,1941,-523,78.14,-36.88,58.31,-19.83,TRUE
"LA PAZ","LARECAJA","TEOPONTE",3859,3637,222,5.75,3202,3197,5,0.16,3074,2954,120,3.9,2230,2264,-34,76.64,-1.52,72.54,-4.09999999999999,TRUE
"LA PAZ","LARECAJA","TIPUANI",4787,4920,-133,-2.78,3655,4311,-656,-17.95,3535,4104,-569,-16.1,2256,3302,-1046,80.46,-46.37,63.82,-16.64,TRUE
"LA PAZ","LOAYZA","CAIROMA",4764,4708,56,1.18,4170,4307,-137,-3.29,3939,4088,-149,-3.78,3089,3778,-689,92.42,-22.3,78.42,-14,TRUE
"LA PAZ","LOAYZA","LURIBAY",5494,5337,157,2.86,4938,4917,21,0.43,4773,4761,12,0.25,4063,4426,-363,92.96,-8.93,85.12,-7.83999999999999,TRUE
"LA PAZ","LOAYZA","MALLA",815,841,-26,-3.19,761,757,4,0.53,741,725,16,2.16,628,678,-50,93.52,-7.96,84.75,-8.77,TRUE
"LA PAZ","LOAYZA","SAPAHAQUI",6591,6248,343,5.2,5951,5845,106,1.78,5715,5512,203,3.55,4758,5164,-406,93.69,-8.53,83.25,-10.44,TRUE
"LA PAZ","LOAYZA","YACO",3120,3036,84,2.69,2831,2760,71,2.51,2628,2595,33,1.26,2006,2414,-408,93.03,-20.34,76.33,-16.7,TRUE
"LA PAZ","LOS ANDES","BATALLAS",9730,9458,272,2.8,8863,8672,191,2.16,8331,8071,260,3.12,5565,7286,-1721,90.27,-30.93,66.8,-23.47,TRUE
"LA PAZ","LOS ANDES","LAJA",9003,8393,610,6.78,8401,7852,549,6.53,7859,7230,629,8,5997,6682,-685,92.42,-11.42,76.31,-16.11,TRUE
"LA PAZ","LOS ANDES","PUCARANI",14992,14629,363,2.42,13961,13584,377,2.7,12790,12368,422,3.3,8431,11162,-2731,90.25,-32.39,65.92,-24.33,TRUE
"LA PAZ","LOS ANDES","PUERTO PEREZ",3765,3512,253,6.72,3463,3243,220,6.35,3254,3075,179,5.5,2463,2841,-378,92.39,-15.35,75.69,-16.7,TRUE
"LA PAZ","MANCO KAPAC","COPACABANA",8021,7920,101,1.26,7087,7202,-115,-1.62,6736,6775,-39,-0.58,4970,5728,-758,84.55,-15.25,73.78,-10.77,TRUE
"LA PAZ","MANCO KAPAC","SAN PEDRO DE TIQUINA",2825,2953,-128,-4.53,2393,2608,-215,-8.98,2237,2407,-170,-7.6,1517,1968,-451,81.76,-29.73,67.81,-13.95,TRUE
"LA PAZ","MANCO KAPAC","TITO YUPANQUI",954,917,37,3.88,818,812,6,0.73,763,749,14,1.83,509,607,-98,81.04,-19.25,66.71,-14.33,TRUE
"LA PAZ","MUÑECAS","AUCAPATA",2145,2043,102,4.76,1628,1681,-53,-3.26,1479,1491,-12,-0.81,1168,1297,-129,86.99,-11.04,78.97,-8.02,TRUE
"LA PAZ","MUÑECAS","AYATA",3407,3291,116,3.4,2790,2785,5,0.18,2486,2493,-7,-0.28,2103,2272,-169,91.14,-8.04,84.59,-6.55,TRUE
"LA PAZ","MUÑECAS","CHUMA",4423,4388,35,0.79,3839,3884,-45,-1.17,3569,3569,0,0,2834,3286,-452,92.07,-15.95,79.41,-12.66,TRUE
"LA PAZ","MURILLO","ACHOCALLA",13000,11596,1404,10.8,11953,10865,1088,9.1,11412,10243,1169,10.24,8184,8828,-644,86.19,-7.87,71.71,-14.48,TRUE
"LA PAZ","MURILLO","EL ALTO",618529,573155,45374,7.34,563842,528303,35539,6.3,533730,504494,29236,5.48,310114,363276,-53162,72.01,-17.14,58.1,-13.91,TRUE
"LA PAZ","MURILLO","LA PAZ",621143,610296,10847,1.75,558744,556919,1825,0.33,540030,537845,2185,0.4,226395,280385,-53990,52.13,-23.85,41.92,-10.21,TRUE
"LA PAZ","MURILLO","MECAPACA",8191,7834,357,4.36,7565,7309,256,3.38,7285,7027,258,3.54,5519,6019,-500,85.66,-9.06,75.76,-9.89999999999999,TRUE
"LA PAZ","MURILLO","PALCA",7557,7199,358,4.74,6834,6657,177,2.59,6381,6171,210,3.29,5474,5880,-406,95.28,-7.42,85.79,-9.48999999999999,TRUE
"LA PAZ","NOR YUNGAS","CORIPATA",10870,10209,661,6.08,9506,9310,196,2.06,8964,8857,107,1.19,5770,8164,-2394,92.18,-41.49,64.37,-27.81,TRUE
"LA PAZ","NOR YUNGAS","COROICO",9834,9387,447,4.55,8508,8358,150,1.76,8064,7924,140,1.74,5399,6804,-1405,85.87,-26.02,66.95,-18.92,TRUE
"LA PAZ","OMASUYOS","ACHACACHI",23614,23112,502,2.13,21455,21115,340,1.58,19857,19344,513,2.58,13149,17152,-4003,88.67,-30.44,66.22,-22.45,TRUE
"LA PAZ","OMASUYOS","ANCORAIMES",6295,6390,-95,-1.51,5789,5907,-118,-2.04,5440,5558,-118,-2.17,4174,5160,-986,92.84,-23.62,76.73,-16.11,TRUE
"LA PAZ","OMASUYOS","CHUA COCANI",2536,2640,-104,-4.1,2239,2348,-109,-4.87,2108,2172,-64,-3.04,1395,1876,-481,86.37,-34.48,66.18,-20.19,TRUE
"LA PAZ","OMASUYOS","HUARINA",4239,4139,100,2.36,3758,3797,-39,-1.04,3505,3548,-43,-1.23,2352,3181,-829,89.66,-35.25,67.1,-22.56,TRUE
"LA PAZ","OMASUYOS","HUATAJATA",1909,2049,-140,-7.33,1711,1868,-157,-9.18,1607,1748,-141,-8.77,960,1404,-444,80.32,-46.25,59.74,-20.58,TRUE
"LA PAZ","OMASUYOS","SANTIAGO DE HUATA",3536,3505,31,0.88,3167,3213,-46,-1.45,2912,2965,-53,-1.82,2027,2694,-667,90.86,-32.91,69.61,-21.25,TRUE
"LA PAZ","PACAJES","CALACOTO",3473,3416,57,1.64,3006,3086,-80,-2.66,2913,2951,-38,-1.3,2291,2752,-461,93.26,-20.12,78.65,-14.61,TRUE
"LA PAZ","PACAJES","CAQUIAVIRI",4935,4966,-31,-0.63,4191,4436,-245,-5.85,4000,4134,-134,-3.35,3007,3799,-792,91.9,-26.34,75.17,-16.73,TRUE
"LA PAZ","PACAJES","CHARAÑA",1368,1373,-5,-0.37,1107,1196,-89,-8.04,1063,1095,-32,-3.01,703,823,-120,75.16,-17.07,66.13,-9.03,TRUE
"LA PAZ","PACAJES","COMANCHE",1881,1815,66,3.51,1677,1641,36,2.15,1592,1502,90,5.65,1143,1381,-238,91.94,-20.82,71.8,-20.14,TRUE
"LA PAZ","PACAJES","CORO CORO",4709,4721,-12,-0.25,4178,4263,-85,-2.03,3935,4006,-71,-1.8,2915,3593,-678,89.69,-23.26,74.08,-15.61,TRUE
"LA PAZ","PACAJES","NAZACARA DE PACAJES",331,299,32,9.67,275,270,5,1.82,265,254,11,4.15,216,236,-20,92.91,-9.26,81.51,-11.4,TRUE
"LA PAZ","PACAJES","SANTIAGO DE CALLAPA",2754,2802,-48,-1.74,2344,2511,-167,-7.12,2234,2336,-102,-4.57,1627,2127,-500,91.05,-30.73,72.83,-18.22,TRUE
"LA PAZ","PACAJES","WALDO BALLIVIÁN",987,943,44,4.46,919,861,58,6.31,875,818,57,6.51,668,753,-85,92.05,-12.72,76.34,-15.71,TRUE
"LA PAZ","SUD YUNGAS","CHULUMANI",10451,9934,517,4.95,9036,8940,96,1.06,8594,8492,102,1.19,5675,7485,-1810,88.14,-31.89,66.03,-22.11,TRUE
"LA PAZ","SUD YUNGAS","IRUPANA",8498,8020,478,5.62,7370,7143,227,3.08,6873,6709,164,2.39,4718,6004,-1286,89.49,-27.26,68.65,-20.84,TRUE
"LA PAZ","SUD YUNGAS","LA ASUNTA",18719,17539,1180,6.3,16255,15853,402,2.47,15395,15015,380,2.47,11294,13633,-2339,90.8,-20.71,73.36,-17.44,TRUE
"LA PAZ","SUD YUNGAS","PALOS BLANCOS",12190,11831,359,2.95,10274,10524,-250,-2.43,9779,9858,-79,-0.81,7370,8428,-1058,85.49,-14.36,75.37,-10.12,TRUE
"LA PAZ","SUD YUNGAS","YANACACHI",2696,2610,86,3.19,2364,2381,-17,-0.72,2239,2270,-31,-1.38,1760,2026,-266,89.25,-15.11,78.61,-10.64,TRUE
"ORURO","AVAROA","CHALLAPATA",17222,16614,608,3.53,15025,14995,30,0.2,13751,13372,379,2.76,7755,10306,-2551,77.07,-32.89,56.4,-20.67,TRUE
"ORURO","AVAROA","SANTUARIO DE QUILLACAS",1897,1863,34,1.79,1677,1718,-41,-2.44,1595,1620,-25,-1.57,1200,1474,-274,90.99,-22.83,75.24,-15.75,TRUE
"ORURO","CARANGAS","CHOQUECOTA",719,701,18,2.5,556,607,-51,-9.17,533,573,-40,-7.5,440,526,-86,91.8,-19.55,82.55,-9.25,TRUE
"ORURO","CARANGAS","CORQUE",4738,4653,85,1.79,4013,4119,-106,-2.64,3871,3895,-24,-0.62,3025,3383,-358,86.85,-11.83,78.15,-8.69999999999999,TRUE
"ORURO","CERCADO","CARACOLLO",11956,11778,178,1.49,10600,10766,-166,-1.57,9959,9984,-25,-0.25,6787,8412,-1625,84.25,-23.94,68.15,-16.1,TRUE
"ORURO","CERCADO","EL CHORO",1978,2010,-32,-1.62,1677,1811,-134,-7.99,1555,1646,-91,-5.85,1104,1434,-330,87.12,-29.89,71,-16.12,TRUE
"ORURO","CERCADO","ORURO",195448,185714,9734,4.98,172669,168781,3888,2.25,164322,159799,4523,2.75,72418,91946,-19528,57.54,-26.97,44.07,-13.47,TRUE
"ORURO","CERCADO","PARI",8001,7633,368,4.6,7290,7179,111,1.52,6760,6426,334,4.94,4649,5483,-834,85.33,-17.94,68.77,-16.56,TRUE
"ORURO","LADISLAO CABRERA","PAMPA AULLAGAS",1535,1513,22,1.43,1368,1401,-33,-2.41,1284,1285,-1,-0.08,868,1158,-290,90.12,-33.41,67.6,-22.52,TRUE
"ORURO","LADISLAO CABRERA","SALINAS DE GARCI MENDOZA",4104,3958,146,3.56,3507,3592,-85,-2.42,3295,3303,-8,-0.24,2278,2892,-614,87.56,-26.95,69.14,-18.42,TRUE
"ORURO","LITORAL","CRUZ DE MACHACAMARCA",504,537,-33,-6.55,486,488,-2,-0.41,469,467,2,0.43,299,306,-7,65.52,-2.34,63.75,-1.77,TRUE
"ORURO","LITORAL","ESCARA",596,657,-61,-10.23,554,581,-27,-4.87,509,563,-54,-10.61,284,353,-69,62.7,-24.3,55.8,-6.90000000000001,TRUE
"ORURO","LITORAL","ESMERALDA",504,499,5,0.99,485,454,31,6.39,481,448,33,6.86,286,295,-9,65.85,-3.15,59.46,-6.38999999999999,TRUE
"ORURO","LITORAL","HUACHACALLA",654,621,33,5.05,341,422,-81,-23.75,329,404,-75,-22.8,204,329,-125,81.44,-61.27,62.01,-19.43,TRUE
"ORURO","LITORAL","YUNGUYO DEL LITORAL",126,128,-2,-1.59,94,127,-33,-35.11,88,124,-36,-40.91,45,86,-41,69.35,-91.11,51.14,-18.21,TRUE
"ORURO","MEJILLONES","CARANGAS",168,165,3,1.79,139,147,-8,-5.76,138,145,-7,-5.07,77,93,-16,64.14,-20.78,55.8,-8.34,TRUE
"ORURO","MEJILLONES","LA RIVERA",250,234,16,6.4,250,232,18,7.2,245,227,18,7.35,121,126,-5,55.51,-4.13,49.39,-6.12,TRUE
"ORURO","MEJILLONES","TODOS SANTOS",254,246,8,3.15,192,193,-1,-0.52,184,174,10,5.43,121,129,-8,74.14,-6.61,65.76,-8.38,TRUE
"ORURO","NOR CARANGAS","SANTIAGO DE HUAYLLAMARCA",2952,2904,48,1.63,2622,2677,-55,-2.1,2509,2473,36,1.43,1814,2096,-282,84.76,-15.55,72.3,-12.46,TRUE
"ORURO","PANTALEON DALENCE","HUANUNI",14693,14760,-67,-0.46,12913,13628,-715,-5.54,12149,12769,-620,-5.1,8392,10484,-2092,82.11,-24.93,69.08,-13.03,TRUE
"ORURO","PANTALEON DALENCE","MACHACAMARCA",2521,2511,10,0.4,2155,2278,-123,-5.71,2038,2135,-97,-4.76,1298,1686,-388,78.97,-29.89,63.69,-15.28,TRUE
"ORURO","POOPÓ","ANTEQUERA",1504,1522,-18,-1.2,1343,1412,-69,-5.14,1253,1305,-52,-4.15,596,942,-346,72.18,-58.05,47.57,-24.61,TRUE
"ORURO","POOPÓ","PAZÑA",2898,2886,12,0.41,2519,2637,-118,-4.68,2328,2412,-84,-3.61,1406,1909,-503,79.15,-35.78,60.4,-18.75,TRUE
"ORURO","POOPÓ","POOPÓ",3577,3500,77,2.15,3177,3217,-40,-1.26,2955,2958,-3,-0.1,2000,2415,-415,81.64,-20.75,67.68,-13.96,TRUE
"ORURO","SABAYA","CHIPAYA",883,813,70,7.93,595,635,-40,-6.72,571,579,-8,-1.4,425,469,-44,81,-10.35,74.43,-6.56999999999999,TRUE
"ORURO","SABAYA","COIPASA",382,378,4,1.05,346,372,-26,-7.51,339,340,-1,-0.29,153,232,-79,68.24,-51.63,45.13,-23.11,TRUE
"ORURO","SABAYA","SABAYA",3361,3389,-28,-0.83,3036,3082,-46,-1.52,2954,2978,-24,-0.81,1180,1620,-440,54.4,-37.29,39.95,-14.45,TRUE
"ORURO","SAJAMA","CURAHUARA DE CARANGAS",2638,2621,17,0.64,1964,2214,-250,-12.73,1834,2051,-217,-11.83,1332,1858,-526,90.59,-39.49,72.63,-17.96,TRUE
"ORURO","SAJAMA","TURCO",2308,2259,49,2.12,1934,2038,-104,-5.38,1855,1939,-84,-4.53,1419,1721,-302,88.76,-21.28,76.5,-12.26,TRUE
"ORURO","SAN PEDRO DE TOTORA","SAN PEDRO DE TOTORA",2598,2327,271,10.43,2270,2189,81,3.57,2145,2051,94,4.38,1820,1877,-57,91.52,-3.13,84.85,-6.67,TRUE
"ORURO","SAUCARI","TOLEDO",3441,3493,-52,-1.51,2862,3081,-219,-7.65,2729,2871,-142,-5.2,1947,2409,-462,83.91,-23.73,71.34,-12.57,TRUE
"ORURO","SEBASTIAN PAGADOR","SANTIAGO DE HUARI",4810,4720,90,1.87,4244,4372,-128,-3.02,3957,4030,-73,-1.84,2572,3402,-830,84.42,-32.27,65,-19.42,TRUE
"ORURO","SUD CARANGAS","BELÉN DE ANDAMARCA",865,909,-44,-5.09,792,830,-38,-4.8,750,781,-31,-4.13,533,676,-143,86.56,-26.83,71.07,-15.49,TRUE
"ORURO","SUD CARANGAS","SANTIAGO DE ANDAMARCA",2409,2434,-25,-1.04,2032,2200,-168,-8.27,1949,2056,-107,-5.49,1574,1879,-305,91.39,-19.38,80.76,-10.63,TRUE
"ORURO","TOMAS BARRON","EUCALIPTUS",2622,2626,-4,-0.15,2288,2398,-110,-4.81,2194,2265,-71,-3.24,1663,1954,-291,86.27,-17.5,75.8,-10.47,TRUE
"PANDO","ABUNÁ","INGAVI",732,509,223,30.46,564,397,167,29.61,535,375,160,29.91,276,145,131,38.67,47.46,51.59,12.92,FALSE
"PANDO","ABUNÁ","SANTA ROSA DEL ABUNÁ",1104,1065,39,3.53,842,916,-74,-8.79,818,828,-10,-1.22,504,549,-45,66.3,-8.93,61.61,-4.69,TRUE
"PANDO","GENERAL FEDERICO ROMÁN","NUEVA ESPERANZA",1077,781,296,27.48,668,641,27,4.04,640,611,29,4.53,338,385,-47,63.01,-13.91,52.81,-10.2,TRUE
"PANDO","GENERAL FEDERICO ROMÁN","SANTOS MERCADO",1235,792,443,35.87,884,664,220,24.89,859,645,214,24.91,463,304,159,47.13,34.34,53.9,6.77,FALSE
"PANDO","GENERAL FEDERICO ROMÁN","VILLA NUEVA (LOMA ALTA)",1054,929,125,11.86,788,812,-24,-3.05,766,782,-16,-2.09,415,466,-51,59.59,-12.29,54.18,-5.41,TRUE
"PANDO","MADRE DE DIOS","EL SENA",3041,2588,453,14.9,2287,2152,135,5.9,2203,2014,189,8.58,1077,1123,-46,55.76,-4.27,48.89,-6.87,TRUE
"PANDO","MADRE DE DIOS","PUERTO GONZALO MORENO",3109,2465,644,20.71,2265,2177,88,3.89,2188,2051,137,6.26,1304,1293,11,63.04,0.84,59.6,-3.44,FALSE
"PANDO","MADRE DE DIOS","SAN LORENZO",3029,2885,144,4.75,2373,2560,-187,-7.88,2286,2390,-104,-4.55,1441,1544,-103,64.6,-7.15,63.04,-1.56,TRUE
"PANDO","MANURIPI","FILADELFIA",3037,2649,388,12.78,2415,2393,22,0.91,2329,2231,98,4.21,1356,1314,42,58.9,3.1,58.22,-0.68,FALSE
"PANDO","MANURIPI","PUERTO RICO",3608,3333,275,7.62,2563,2724,-161,-6.28,2420,2580,-160,-6.61,1279,1509,-230,58.49,-17.98,52.85,-5.64,TRUE
"PANDO","MANURIPI","SAN PEDRO",747,779,-32,-4.28,467,630,-163,-34.9,458,589,-131,-28.6,205,248,-43,42.11,-20.98,44.76,2.65,TRUE
"PANDO","NICOLAS SUAREZ","BELLA FLOR",1897,1746,151,7.96,1414,1479,-65,-4.6,1367,1401,-34,-2.49,751,749,2,53.46,0.27,54.94,1.48,FALSE
"PANDO","NICOLAS SUAREZ","BOLPEBRA",1234,1135,99,8.02,948,987,-39,-4.11,911,936,-25,-2.74,408,446,-38,47.65,-9.31,44.79,-2.86,TRUE
"PANDO","NICOLAS SUAREZ","COBIJA",34146,32637,1509,4.42,27713,28143,-430,-1.55,26596,26461,135,0.51,10356,12511,-2155,47.28,-20.81,38.94,-8.34,TRUE
"PANDO","NICOLAS SUAREZ","PORVENIR",3533,3303,230,6.51,2853,2921,-68,-2.38,2778,2737,41,1.48,1528,1703,-175,62.22,-11.45,55,-7.22,TRUE
"POTOSÍ","ALONZO DE IBAÑEZ","CARIPUYO",3701,3663,38,1.03,3151,3294,-143,-4.54,2855,3066,-211,-7.39,2492,2930,-438,95.56,-17.58,87.29,-8.27,TRUE
"POTOSÍ","ALONZO DE IBAÑEZ","SACACA",8330,8030,300,3.6,7398,7227,171,2.31,6915,6566,349,5.05,5510,6087,-577,92.7,-10.47,79.68,-13.02,TRUE
"POTOSÍ","ANTONIO QUIJARRO","PORCO",4856,4731,125,2.57,4217,4322,-105,-2.49,4012,3902,110,2.74,1061,2574,-1513,65.97,-142.6,26.45,-39.52,TRUE
"POTOSÍ","ANTONIO QUIJARRO","TOMAVE",5480,5185,295,5.38,4595,4581,14,0.3,4252,4143,109,2.56,2379,3581,-1202,86.43,-50.53,55.95,-30.48,TRUE
"POTOSÍ","ANTONIO QUIJARRO","UYUNI",17796,16827,969,5.45,14978,14668,310,2.07,14030,13295,735,5.24,6148,8869,-2721,66.71,-44.26,43.82,-22.89,TRUE
"POTOSÍ","CHARCAS","SAN PEDRO DE BUENA VISTA",10774,9571,1203,11.17,8455,7829,626,7.4,7742,6885,857,11.07,6542,6543,-1,95.03,-0.02,84.5,-10.53,TRUE
"POTOSÍ","CHARCAS","TORO TORO",4816,4676,140,2.91,3958,3937,21,0.53,3773,3591,182,4.82,3305,3360,-55,93.57,-1.66,87.6,-5.97,TRUE
"POTOSÍ","CHAYANTA","COLQUECHACA",13157,13138,19,0.14,10428,11088,-660,-6.33,9146,9799,-653,-7.14,7291,9052,-1761,92.38,-24.15,79.72,-12.66,TRUE
"POTOSÍ","CHAYANTA","OCURÍ",5087,5226,-139,-2.73,3781,4240,-459,-12.14,3250,3386,-136,-4.18,2289,3032,-743,89.55,-32.46,70.43,-19.12,TRUE
"POTOSÍ","CHAYANTA","POCOATA",9983,9638,345,3.46,8487,8507,-20,-0.24,7700,7828,-128,-1.66,6393,7243,-850,92.53,-13.3,83.03,-9.5,TRUE
"POTOSÍ","CHAYANTA","RAVELO",7547,7394,153,2.03,6073,6136,-63,-1.04,5293,4995,298,5.63,4118,4632,-514,92.73,-12.48,77.8,-14.93,TRUE
"POTOSÍ","CORNELIO SAAVEDRA","BETANZOS",15538,15333,205,1.32,12846,13117,-271,-2.11,11673,11419,254,2.18,7750,9966,-2216,87.28,-28.59,66.39,-20.89,TRUE
"POTOSÍ","CORNELIO SAAVEDRA","CHAQUÍ",4462,4559,-97,-2.17,3470,3796,-326,-9.39,2943,3118,-175,-5.95,1409,2570,-1161,82.42,-82.4,47.88,-34.54,TRUE
"POTOSÍ","CORNELIO SAAVEDRA","TACOBAMBA",3751,3902,-151,-4.03,2865,3242,-377,-13.16,2599,2911,-312,-12,1782,2724,-942,93.58,-52.86,68.56,-25.02,TRUE
"POTOSÍ","DANIEL CAMPOS","LLICA",1939,1987,-48,-2.48,1587,1681,-94,-5.92,1531,1600,-69,-4.51,1110,1369,-259,85.56,-23.33,72.5,-13.06,TRUE
"POTOSÍ","DANIEL CAMPOS","TAHUA",617,533,84,13.61,542,479,63,11.62,518,460,58,11.2,387,364,23,79.13,5.94,74.71,-4.42,FALSE
"POTOSÍ","ENRIQUE BALDIVIESO","SAN AGUSTÍN",872,822,50,5.73,745,711,34,4.56,719,669,50,6.95,477,518,-41,77.43,-8.6,66.34,-11.09,TRUE
"POTOSÍ","GENERAL BERNARDINO BILBAO","ACASIO",2310,2266,44,1.9,1850,1917,-67,-3.62,1748,1759,-11,-0.63,1473,1658,-185,94.26,-12.56,84.27,-9.99000000000001,TRUE
"POTOSÍ","GENERAL BERNARDINO BILBAO","ARAMPAMPA",1566,1528,38,2.43,1297,1302,-5,-0.39,1228,1229,-1,-0.08,1132,1171,-39,95.28,-3.45,92.18,-3.09999999999999,TRUE
"POTOSÍ","JOSE MARIA LINARES","CAIZA D",4815,4864,-49,-1.02,3896,4127,-231,-5.93,3568,3750,-182,-5.1,1881,3113,-1232,83.01,-65.5,52.72,-30.29,TRUE
"POTOSÍ","JOSE MARIA LINARES","CKOCHAS",5789,5784,5,0.09,4545,4950,-405,-8.91,4223,4428,-205,-4.85,3318,4133,-815,93.34,-24.56,78.57,-14.77,TRUE
"POTOSÍ","JOSE MARIA LINARES","PUNA",10129,10261,-132,-1.3,7719,8525,-806,-10.44,6919,7532,-613,-8.86,3928,6304,-2376,83.7,-60.49,56.77,-26.93,TRUE
"POTOSÍ","MODESTO OMISTE","VILLAZÓN",27221,26480,741,2.72,21181,21884,-703,-3.32,19575,19661,-86,-0.44,12088,14672,-2584,74.62,-21.38,61.75,-12.87,TRUE
"POTOSÍ","NOR CHICHAS","COTAGAITA",11113,11077,36,0.32,8957,9699,-742,-8.28,8400,8991,-591,-7.04,6194,7990,-1796,88.87,-29,73.74,-15.13,TRUE
"POTOSÍ","NOR CHICHAS","VITICHI",4727,4579,148,3.13,3554,3725,-171,-4.81,3247,3368,-121,-3.73,2370,2955,-585,87.74,-24.68,72.99,-14.75,TRUE
"POTOSÍ","NOR LIPEZ","COLCHA K",5899,5663,236,4,4918,5019,-101,-2.05,4677,4702,-25,-0.53,2928,3780,-852,80.39,-29.1,62.6,-17.79,TRUE
"POTOSÍ","NOR LIPEZ","SAN PEDRO DE QUEMES",387,292,95,24.55,306,237,69,22.55,302,219,83,27.48,178,164,14,74.89,7.87,58.94,-15.95,FALSE
"POTOSÍ","RAFAEL BUSTILLO","CHAYANTA",7143,6783,360,5.04,6299,6188,111,1.76,5722,5422,300,5.24,4127,4737,-610,87.37,-14.78,72.13,-15.24,TRUE
"POTOSÍ","RAFAEL BUSTILLO","CHUQUIHUTA AYLLU JUCUMANI",3324,3280,44,1.32,2775,2887,-112,-4.04,2316,2472,-156,-6.74,1510,2110,-600,85.36,-39.74,65.2,-20.16,TRUE
"POTOSÍ","RAFAEL BUSTILLO","LLALLAGUA",25797,25584,213,0.83,22498,23110,-612,-2.72,20534,21021,-487,-2.37,9687,15289,-5602,72.73,-57.83,47.18,-25.55,TRUE
"POTOSÍ","RAFAEL BUSTILLO","UNCÍA",10970,10923,47,0.43,9397,9694,-297,-3.16,8494,8412,82,0.97,4271,6267,-1996,74.5,-46.73,50.28,-24.22,TRUE
"POTOSÍ","SUD CHICHAS","ATOCHA",5842,6045,-203,-3.47,4956,5312,-356,-7.18,4610,4991,-381,-8.26,2943,4145,-1202,83.05,-40.84,63.84,-19.21,TRUE
"POTOSÍ","SUD CHICHAS","TUPIZA",26269,25481,788,3,21933,21979,-46,-0.21,20279,20303,-24,-0.12,12522,15977,-3455,78.69,-27.59,61.75,-16.94,TRUE
"POTOSÍ","SUD LIPEZ","MOJINETE",265,274,-9,-3.4,218,235,-17,-7.8,206,224,-18,-8.74,187,216,-29,96.43,-15.51,90.78,-5.65000000000001,TRUE
"POTOSÍ","SUD LIPEZ","SAN ANTONIO DE ESMORUCO",719,682,37,5.15,590,585,5,0.85,560,567,-7,-1.25,433,514,-81,90.65,-18.71,77.32,-13.33,TRUE
"POTOSÍ","SUD LIPEZ","SAN PABLO DE LIPEZ",1126,1041,85,7.55,972,951,21,2.16,894,853,41,4.59,586,703,-117,82.42,-19.97,65.55,-16.87,TRUE
"POTOSÍ","TOMAS FRIAS","POTOSÍ",133370,127638,5732,4.3,117603,115001,2602,2.21,113119,105465,7654,6.77,15984,44671,-28687,42.36,-179.47,14.13,-28.23,TRUE
"POTOSÍ","TOMAS FRIAS","TINGUIPAYA",8846,8884,-38,-0.43,7079,7427,-348,-4.92,6097,6015,82,1.34,4261,5272,-1011,87.65,-23.73,69.89,-17.76,TRUE
"POTOSÍ","TOMAS FRIAS","URMIRI",706,711,-5,-0.71,630,639,-9,-1.43,594,586,8,1.35,337,503,-166,85.84,-49.26,56.73,-29.11,TRUE
"POTOSÍ","TOMAS FRIAS","YOCALLA",3981,3809,172,4.32,3469,3447,22,0.63,3191,3069,122,3.82,1219,2457,-1238,80.06,-101.56,38.2,-41.86,TRUE
"SANTA CRUZ","ANDRES IBAÑEZ","COTOCA",31201,28898,2303,7.38,26885,25329,1556,5.79,25624,24044,1580,6.17,11345,12609,-1264,52.44,-11.14,44.27,-8.16999999999999,TRUE
"SANTA CRUZ","ANDRES IBAÑEZ","EL TORNO",31265,30108,1157,3.7,27455,26756,699,2.55,25502,24569,933,3.66,14547,16199,-1652,65.93,-11.36,57.04,-8.89000000000001,TRUE
"SANTA CRUZ","ANDRES IBAÑEZ","LA GUARDIA",54702,47496,7206,13.17,47994,42268,5726,11.93,45376,40158,5218,11.5,21513,22592,-1079,56.26,-5.02,47.41,-8.85,TRUE
"SANTA CRUZ","ANDRES IBAÑEZ","PORONGO",7987,6752,1235,15.46,6892,5912,980,14.22,6577,5547,1030,15.66,2072,2079,-7,37.48,-0.34,31.5,-5.98,TRUE
"SANTA CRUZ","ANDRES IBAÑEZ","SANTA CRUZ DE LA SIERRA",958596,916127,42469,4.43,824746,799542,25204,3.06,789518,767984,21534,2.73,268720,333791,-65071,43.46,-24.22,34.04,-9.42,TRUE
"SANTA CRUZ","ANGEL SANDOVAL","SAN MATÍAS",7305,6944,361,4.94,5712,5468,244,4.27,5425,5034,391,7.21,2599,2244,355,44.58,13.66,47.91,3.33,FALSE
"SANTA CRUZ","CHIQUITOS","PAILÓN",12733,11115,1618,12.71,10372,9535,837,8.07,9919,9013,906,9.13,4448,5033,-585,55.84,-13.15,44.84,-11,TRUE
"SANTA CRUZ","CHIQUITOS","ROBORÉ",9529,9187,342,3.59,7389,7799,-410,-5.55,7198,7334,-136,-1.89,2346,2533,-187,34.54,-7.97,32.59,-1.95,TRUE
"SANTA CRUZ","CHIQUITOS","SAN JOSÉ DE CHIQUITOS",11088,9993,1095,9.88,8733,8434,299,3.42,8450,8004,446,5.28,3051,2773,278,34.65,9.11,36.11,1.46,FALSE
"SANTA CRUZ","CORDILLERA","BOYUIBE",2494,2503,-9,-0.36,1868,1997,-129,-6.91,1779,1856,-77,-4.33,940,1133,-193,61.05,-20.53,52.84,-8.20999999999999,TRUE
"SANTA CRUZ","CORDILLERA","CABEZAS",9342,8757,585,6.26,7739,7573,166,2.14,7251,7046,205,2.83,3246,4916,-1670,69.77,-51.45,44.77,-25,TRUE
"SANTA CRUZ","CORDILLERA","CAMIRI",23305,22877,428,1.84,19359,20020,-661,-3.41,18469,18818,-349,-1.89,7824,10188,-2364,54.14,-30.21,42.36,-11.78,TRUE
"SANTA CRUZ","CORDILLERA","CHARAGUA",10794,9450,1344,12.45,8911,7281,1630,18.29,8439,6457,1982,23.49,4898,4191,707,64.91,14.43,58.04,-6.87,FALSE
"SANTA CRUZ","CORDILLERA","CUEVO",2349,2176,173,7.36,1741,1786,-45,-2.58,1674,1659,15,0.9,723,908,-185,54.73,-25.59,43.19,-11.54,TRUE
"SANTA CRUZ","CORDILLERA","GUTIÉRREZ",5427,5158,269,4.96,4570,4497,73,1.6,4299,4022,277,6.44,2572,3215,-643,79.94,-25,59.83,-20.11,TRUE
"SANTA CRUZ","CORDILLERA","LAGUNILLAS",3054,2889,165,5.4,2490,2419,71,2.85,2350,2215,135,5.74,1296,1512,-216,68.26,-16.67,55.15,-13.11,TRUE
"SANTA CRUZ","FLORIDA","MAIRANA",6446,6296,150,2.33,5638,5714,-76,-1.35,5119,5249,-130,-2.54,2793,3355,-562,63.92,-20.12,54.56,-9.36,TRUE
"SANTA CRUZ","FLORIDA","PAMPAGRANDE",5014,4926,88,1.76,4335,4394,-59,-1.36,4030,4001,29,0.72,2269,2609,-340,65.21,-14.98,56.3,-8.91,TRUE
"SANTA CRUZ","FLORIDA","QUIRUSILLAS",1073,1043,30,2.8,865,901,-36,-4.16,782,806,-24,-3.07,317,391,-74,48.51,-23.34,40.54,-7.97,TRUE
"SANTA CRUZ","FLORIDA","SAMAIPATA",5906,5666,240,4.06,5126,4942,184,3.59,4764,4467,297,6.23,1822,2269,-447,50.79,-24.53,38.25,-12.54,TRUE
"SANTA CRUZ","GERMAN BUSCH","EL CÁRMEN RIVERO TORREZ",3061,2785,276,9.02,2297,2410,-113,-4.92,2219,2203,16,0.72,1030,1167,-137,52.97,-13.3,46.42,-6.55,TRUE
"SANTA CRUZ","GERMAN BUSCH","PUERTO QUIJARRO",10886,11159,-273,-2.51,8448,9020,-572,-6.77,7756,8407,-651,-8.39,3203,4226,-1023,50.27,-31.94,41.3,-8.97000000000001,TRUE
"SANTA CRUZ","GERMAN BUSCH","PUERTO SUAREZ",10307,10258,49,0.48,8136,8546,-410,-5.04,7850,8221,-371,-4.73,2677,3099,-422,37.7,-15.76,34.1,-3.6,TRUE
"SANTA CRUZ","GUARAYOS","ASCENCIÓN DE GUARAYOS",13038,12095,943,7.23,10576,9991,585,5.53,10180,9267,913,8.97,4739,4904,-165,52.92,-3.48,46.55,-6.37,TRUE
"SANTA CRUZ","GUARAYOS","EL PUENTE",6042,6009,33,0.55,4820,5188,-368,-7.63,4590,4844,-254,-5.53,2736,3423,-687,70.66,-25.11,59.61,-11.05,TRUE
"SANTA CRUZ","GUARAYOS","URUBICHÁ",3338,3197,141,4.22,2710,2800,-90,-3.32,2594,2523,71,2.74,1259,1661,-402,65.83,-31.93,48.54,-17.29,TRUE
"SANTA CRUZ","ICHILO","BUENA VISTA",7741,7854,-113,-1.46,6429,6630,-201,-3.13,6146,6224,-78,-1.27,2931,3305,-374,53.1,-12.76,47.69,-5.41,TRUE
"SANTA CRUZ","ICHILO","SAN CARLOS",10682,10402,280,2.62,9200,9003,197,2.14,8621,8363,258,2.99,4264,4798,-534,57.37,-12.52,49.46,-7.91,TRUE
"SANTA CRUZ","ICHILO","SAN JUAN DE YAPACANÍ",4438,4329,109,2.46,3766,3769,-3,-0.08,3587,3523,64,1.78,1807,2221,-414,63.04,-22.91,50.38,-12.66,TRUE
"SANTA CRUZ","ICHILO","YAPACANÍ",27548,26797,751,2.73,23349,23450,-101,-0.43,22185,21786,399,1.8,14983,17025,-2042,78.15,-13.63,67.54,-10.61,TRUE
"SANTA CRUZ","MANUEL MARÍA CABALLERO","COMARAPA",8604,8481,123,1.43,7581,7692,-111,-1.46,7010,6938,72,1.03,4319,4952,-633,71.38,-14.66,61.61,-9.77,TRUE
"SANTA CRUZ","MANUEL MARÍA CABALLERO","SAIPINA",3270,3129,141,4.31,2845,2841,4,0.14,2701,2650,51,1.89,1818,2055,-237,77.55,-13.04,67.31,-10.24,TRUE
"SANTA CRUZ","ÑUFLO DE CHAVEZ","CONCEPCIÓN",11221,10316,905,8.07,9549,9237,312,3.27,9129,8586,543,5.95,4761,5162,-401,60.12,-8.42,52.15,-7.97,TRUE
"SANTA CRUZ","ÑUFLO DE CHAVEZ","CUATRO CAÑADAS",10062,9527,535,5.32,8704,8566,138,1.59,8196,8027,169,2.06,5098,6212,-1114,77.39,-21.85,62.2,-15.19,TRUE
"SANTA CRUZ","ÑUFLO DE CHAVEZ","SAN ANTONIO DE LOMERIO",2870,2756,114,3.97,2498,2471,27,1.08,2416,2359,57,2.36,1823,1872,-49,79.36,-2.69,75.46,-3.90000000000001,TRUE
"SANTA CRUZ","ÑUFLO DE CHAVEZ","SAN JAVIER",6501,6015,486,7.48,5493,5311,182,3.31,5289,5037,252,4.76,2234,2315,-81,45.96,-3.63,42.24,-3.72,TRUE
"SANTA CRUZ","ÑUFLO DE CHAVEZ","SAN JULIÁN",23050,22759,291,1.26,20178,20385,-207,-1.03,18735,19215,-480,-2.56,13272,16055,-2783,83.55,-20.97,70.84,-12.71,TRUE
"SANTA CRUZ","ÑUFLO DE CHAVEZ","SAN RAMÓN",4377,4056,321,7.33,3621,3587,34,0.94,3407,3321,86,2.52,1444,1495,-51,45.02,-3.53,42.38,-2.64,TRUE
"SANTA CRUZ","OBISPO SANTISTEVAN","FERNÁNDEZ ALONZO",6695,6609,86,1.28,5820,5749,71,1.22,5492,5366,126,2.29,3561,4241,-680,79.03,-19.1,64.84,-14.19,TRUE
"SANTA CRUZ","OBISPO SANTISTEVAN","GENERAL SAAVEDRA",7713,7433,280,3.63,6606,6693,-87,-1.32,6257,6210,47,0.75,3073,3787,-714,60.98,-23.23,49.11,-11.87,TRUE
"SANTA CRUZ","OBISPO SANTISTEVAN","MINEROS",13416,12740,676,5.04,11532,11240,292,2.53,10889,10430,459,4.22,4878,6452,-1574,61.86,-32.27,44.8,-17.06,TRUE
"SANTA CRUZ","OBISPO SANTISTEVAN","MONTERO",73737,70873,2864,3.88,63852,62249,1603,2.51,60739,59424,1315,2.17,25021,32243,-7222,54.26,-28.86,41.19,-13.07,TRUE
"SANTA CRUZ","OBISPO SANTISTEVAN","SAN PEDRO",7207,7078,129,1.79,6177,6059,118,1.91,5921,5717,204,3.45,3680,4508,-828,78.85,-22.5,62.15,-16.7,TRUE
"SANTA CRUZ","SARA","COLPA BÉLGICA",3596,3376,220,6.12,3047,2848,199,6.53,2965,2723,242,8.16,1130,1346,-216,49.43,-19.12,38.11,-11.32,TRUE
"SANTA CRUZ","SARA","PORTACHUELO",11402,10880,522,4.58,10110,9757,353,3.49,9729,9279,450,4.63,2315,2787,-472,30.04,-20.39,23.79,-6.25,TRUE
"SANTA CRUZ","SARA","SANTA ROSA DEL SARA",8521,8265,256,3,7187,7175,12,0.17,6882,6631,251,3.65,3720,4127,-407,62.24,-10.94,54.05,-8.19,TRUE
"SANTA CRUZ","VALLEGRANDE","MOROMORO",1606,1540,66,4.11,1426,1421,5,0.35,1320,1214,106,8.03,594,558,36,45.96,6.06,45,-0.960000000000001,FALSE
"SANTA CRUZ","VALLEGRANDE","POSTRERVALLE",1033,988,45,4.36,836,844,-8,-0.96,782,758,24,3.07,211,200,11,26.39,5.21,26.98,0.59,FALSE
"SANTA CRUZ","VALLEGRANDE","PUCARA",1068,1016,52,4.87,915,891,24,2.62,870,824,46,5.29,413,397,16,48.18,3.87,47.47,-0.710000000000001,FALSE
"SANTA CRUZ","VALLEGRANDE","TRIGAL",1222,1097,125,10.23,1018,952,66,6.48,912,862,50,5.48,416,411,5,47.68,1.2,45.61,-2.07,FALSE
"SANTA CRUZ","VALLEGRANDE","VALLEGRANDE",10934,10669,265,2.42,9353,9524,-171,-1.83,8731,8537,194,2.22,3086,3790,-704,44.39,-22.81,35.35,-9.04,TRUE
"SANTA CRUZ","VELASCO","SAN IGNACIO DE VELASCO",24417,22981,1436,5.88,19755,19594,161,0.81,18907,18009,898,4.75,6365,6349,16,35.25,0.25,33.66,-1.59,FALSE
"SANTA CRUZ","VELASCO","SAN MIGUEL DE VELASCO",5808,5353,455,7.83,4921,4698,223,4.53,4737,4347,390,8.23,2510,2270,240,52.22,9.56,52.99,0.770000000000003,FALSE
"SANTA CRUZ","VELASCO","SAN RAFAEL",2662,2381,281,10.56,2091,1933,158,7.56,2016,1808,208,10.32,701,527,174,29.15,24.82,34.77,5.62,FALSE
"SANTA CRUZ","WARNES","OKINAWA UNO",6045,5801,244,4.04,5256,5126,130,2.47,4958,4865,93,1.88,1644,2289,-645,47.05,-39.23,33.16,-13.89,TRUE
"SANTA CRUZ","WARNES","WARNES",61856,54273,7583,12.26,53514,47747,5767,10.78,50992,45616,5376,10.54,24424,26544,-2120,58.19,-8.68,47.9,-10.29,TRUE
"TARIJA","ARCE","BERMEJO",25617,24804,813,3.17,20219,21208,-989,-4.89,19309,19611,-302,-1.56,8889,11667,-2778,59.49,-31.25,46.04,-13.45,TRUE
"TARIJA","ARCE","PADCAYA",11809,11353,456,3.86,9733,10154,-421,-4.33,9254,9217,37,0.4,5968,6988,-1020,75.82,-17.09,64.49,-11.33,TRUE
"TARIJA","AVILEZ","URIONDO (CONCEPCIÓN)",9685,9451,234,2.42,8162,8444,-282,-3.46,7674,7429,245,3.19,3859,4446,-587,59.85,-15.21,50.29,-9.56,TRUE
"TARIJA","AVILEZ","YUNCHARÁ",2675,2486,189,7.07,2166,2172,-6,-0.28,2038,1944,94,4.61,1640,1732,-92,89.09,-5.61,80.47,-8.62,TRUE
"TARIJA","BURNET O'CONNOR","ENTRE RÍOS",12240,11624,616,5.03,9993,10019,-26,-0.26,9465,8958,507,5.36,4758,6045,-1287,67.48,-27.05,50.27,-17.21,TRUE
"TARIJA","CERCADO","TARIJA",154092,149370,4722,3.06,130484,133033,-2549,-1.95,125277,124873,404,0.32,38024,50781,-12757,40.67,-33.55,30.35,-10.32,TRUE
"TARIJA","GRAN CHACO","CARAPARÍ",9819,8900,919,9.36,8156,7953,203,2.49,7821,7290,531,6.79,4384,4862,-478,66.69,-10.9,56.05,-10.64,TRUE
"TARIJA","GRAN CHACO","VILLAMONTES",27180,25985,1195,4.4,21674,22738,-1064,-4.91,20767,20956,-189,-0.91,9182,12302,-3120,58.7,-33.98,44.21,-14.49,TRUE
"TARIJA","GRAN CHACO","YACUIBA",61272,58307,2965,4.84,48946,50451,-1505,-3.07,46822,46587,235,0.5,21674,27907,-6233,59.9,-28.76,46.29,-13.61,TRUE
"TARIJA","MENDEZ","EL PUENTE",6567,6482,85,1.29,5168,5619,-451,-8.73,4772,5024,-252,-5.28,2744,3719,-975,74.02,-35.53,57.5,-16.52,TRUE
"TARIJA","MENDEZ","VILLA SAN LORENZO",15291,14589,702,4.59,12357,12693,-336,-2.72,11529,11292,237,2.06,4458,5565,-1107,49.28,-24.83,38.67,-10.61,TRUE
